7
8
7
7
44000410
44002111
40020431
40442404
00020020
00040000
44444400
