5
10
3
2
4400010000
0004424400
0021010124
4024424404
4000010004
