6
8
3
8
44000444
00020200
02000200
44224444
44001144
44111144
