8
9
8
1
444441000
400411440
400211000
400401404
440442400
020000220
042400400
000444444
