7
8
7
6
44000044
44020000
44020440
11102000
11124204
44404020
44400000
