6
9
5
1
444011144
444111144
004442044
020200220
002020000
000444000
